[
	["w", "w", "w", "-", "-", "-", "-", "w", "w", "w", "-", "-", "-", "-", "w"],
	["w", "-", "-", "-", "w", "w", "-", "w", "-", "-", "-", "w", "-", "w", "w"],
	["w", "-", "w", "w", "-", "w", "-", "-", "w", "-", "w", "w", "-", "-", "w"],
	["w", "-", "-", "w", "-", "w", "w", "-", "-", "-", "-", "w", "w", "-", "-"],
	["w", "w", "-", "-", "-", "-", "-", "w", "w", "-", "w", "w", "w", "w", "-"],
	["-", "-", "-", "w", "w", "w", "-", "-", "w", "-", "-", "-", "w", "-", "-"],
	["w", "w", "-", "w", "-", "-", "-", "w", "w", "-", "w", "w", "w", "-", "w"],
	["w", "w", "w", "w", "-", "w", "w", "w", "-", "w", "-", "-", "w", "-", "w"],
	["w", "-", "-", "-", "-", "w", "-", "-", "-", "-", "w", "-", "w", "-", "-"],
	["w", "-", "w", "w", "w", "w", "-", "-", "w", "-", "w", "-", "-", "-", "w"],
	["w", "-", "-", "w", "-", "w", "-", "w", "w", "-", "w", "w", "w", "-", "w"],
	["w", "w", "-", "w", "-", "w", "-", "-", "w", "-", "-", "-", "w", "-", "f"],
	["w", "-", "-", "-", "-", "w", "w", "-", "w", "w", "-", "w", "w", "w", "w"],
	["w", "-", "w", "w", "-", "-", "-", "-", "w", "-", "-", "-", "-", "-", "s"],
	["w", "w", "w", "w", "w", "w", "-", "w", "w", "w", "w", "-", "w", "w", "w"]
]